wwwwwwwwww
w     w  w
w     w  w
w  w  w  w
w  w  w  w
w  w     w
w  w  b  w  
w  w     w
w  wwwwwww
w  wg    w
w  wwww  w
w  w  w  w
w  wwww  w
w        w
wwwwwwwwww