wwwwwwwwww
w bw    ww
w        w
w    w   w
w    w   w
ww  wwwwww
ww      ww
wwww    ww
w       ww
w    w   w
www  ww  w
ww    wwww
w        w
w  ww   gw
wwwwwwwwww