wwwwwwwwww
w ww bww w
w w    w w
w ww  ww w
w w    w w
wwww  wwww
www    www 
w ww  ww w
www    www
wgw      w
w  www   w
w  www   w
w  www   w
w        w
wwwwwwwwww