wwwwwwwwww
www    www
ww       w
w   www  w
w    wb  w
ww  wwwwww
ww   ww  w  
www      w
w        w
w        w
wwwwwww  w
ww    w  w
w        w
wg ww    w
wwwwwwwwww