wwwwwwwwww
w        w
w     w  w
w  wwww  w
w  w bw  w
w  w  w  w
w  w     w  
w   w    w
ww   wwwww
wgw      w
w  www   w
w  www   w
w  www   w
w        w
wwwwwwwwww